pompadour	a hair style in which the hair is swept up from the forehead
toupee	a small hairpiece to cover partial baldness
queue	a line of people or vehicles waiting for something
minstrel	a singer of folk songs
mince	cut into small pieces
grange	a farm or farmhouse with outbuildings
plod	walk heavily and firmly, as when weary, or through mud
reprehensible	bringing or deserving severe rebuke or censure
secessionist	a person who wants to break free from a larger group
peruse	examine or consider with attention and in detail
careen	move at high speed and in an uncontrolled way
breeches	trousers ending above the knee
industry	the action of making of goods and services for sale
artful	not straightforward or candid
canter	a smooth three-beat gait
hallowed	worthy of religious veneration
precarious	not secure; beset with difficulties
peal	a deep prolonged sound
impudent	improperly forward or bold
dingy	thickly covered with ingrained dirt or soot
malady	impairment of normal physiological function
subjection	the act of conquering
tangible	perceptible by the senses, especially the sense of touch
exasperate	make furious
supple	moving and bending with ease
lamentable	bad; unfortunate
vindicate	show to be right by providing justification or proof
finery	elaborate or showy attire and accessories
propound	put forward, as of an idea
placard	a sign posted in a public place
parry	impede the movement of
scathe	the act of damaging something or someone
rapturous	feeling great delight
maraud	raid and rove in search of plunder
appertain	be a part or attribute of
miser	a stingy hoarder of money and possessions
sacrilege	blasphemous behavior
niche	a small concavity
shantytown	a city district with large numbers of crude dwellings
artisanal	relating to or characteristic of a skilled craftsperson
inert	unable to move or resist motion
hark	listen; used mostly in the imperative
eccentricity	strange and unconventional behavior
deftly	in an agile manner
roughhewn	(of stone or timber) shaped or cut crudely
scratch	cut, scrape, or wear away the surface of
ape	any of various primates with short tails or no tail at all
high-strung	in a very tense state
sanctified	made, declared, or believed to be holy
tribunal	an assembly to conduct judicial business
generalize	draw from specific cases for broader cases
despotic	having the characteristics of a tyrannical ruler
lithe	moving and bending with ease
stupor	a state of being half-awake
wend	direct one's course or way
consign	give over to another for care or safekeeping
disconcerted	having self-possession upset; thrown into confusion
prevalence	the quality of being widespread
stigma	a symbol of disgrace or infamy
sentinel	a person employed to keep watch for some anticipated event
ostentatious	intended to attract notice and impress others
guile	shrewdness as demonstrated by being skilled in deception
sensuous	providing perceptible pleasure or gratification
impertinence	the trait of being rude and inclined to take liberties
paltry	contemptibly small in amount or size
quell	suppress or crush completely
patrician	a person of refined upbringing and manners
hombre	an informal term for a youth or man
jade	a semiprecious gemstone that is usually green
petulant	easily irritated or annoyed
pretentious	creating an appearance of importance or distinction
subtlety	the quality of being difficult to detect or analyze
saucy	improperly forward or bold
dividend	a number to be divided by another number
fickle	liable to sudden unpredictable change
bunsen burner	a gas burner used in laboratories
ambrosia	the food and drink of the gods
wholesale	the selling of goods to merchants
barrow	a cart for carrying small loads
veneration	a feeling of profound respect for someone or something
melancholia	extreme depression or sadness
accost	approach and speak to someone aggressively or insistently
subpar	(golf) having a score below par
legalism	strict conformity to the law rather than its spirit
titillating	pleasantly and superficially exciting
estrange	remove from customary environment or associations
abridge	lessen, diminish, or curtail
acerbic	sour or bitter in taste
chaff	material consisting of seed coverings and pieces of stem
sate	fill to contentment
clime	the weather in some location averaged over a period of time
rivet	a heavy metal pin used to fasten two pieces of metal
buttress	a support usually of stone or brick
stargaze	observe things in the night sky
faun	a mythological creature that is half human and half goat
uncanny	surpassing the ordinary or normal
brood	hang over, as of something threatening, dark, or menacing
satiate	fill to satisfaction
antecedent	a preceding occurrence or cause or event
contemporaries	all the people living at the same time or of the same age
credulous	showing a lack of judgment or experience
elicit	call forth, as an emotion, feeling, or response
extant	still in existence; not extinct or destroyed or lost
benign	kind in disposition or manner
intrinsic	belonging to a thing by its very nature
interminable	tiresomely long; seemingly without end
foreboding	a feeling of evil to come
granary	a storehouse for threshed grain or animal feed
alight	settle or come to rest
chiefly	for the most part
brook	a natural stream of water smaller than a river
affable	diffusing warmth and friendliness
efface	remove by or as if by rubbing or erasing
adroit	quick or skillful or adept in action or thought
appellate	relating to challenges to a legal decision
servile	submissive or fawning in attitude or behavior
libel	a false and malicious publication
leviathan	the largest or most massive thing of its kind
mote	a tiny piece of anything
denomination	identifying word by which someone or something is called
mortification	strong feelings of embarrassment
visage	the human face
levy	impose and collect
pas de deux	a dance for two people
genus	taxonomic group containing one or more species
lemur	a small, large-eyed primate native to Madagascar
emblematize	express indirectly by an image, form, or model
revel	take delight in
disorientation	confusion about where you are and how to proceed
pizzazz	the activeness of an energetic personality
momentary	lasting for a markedly brief time
culminate	end, especially to reach a final or climactic stage
verily	in truth; certainly
impend	be imminent or about to happen
vagabond	a wanderer with no established residence or means of support
privy	informed about something secret or not generally known
grindstone	a device for sharpening metal tools
irregularly	in a manner that does not follow a pattern
reprove	reprimand, scold, or express dissatisfaction with
seclusion	the act of isolating oneself from others
gilded	made from or covered with gold
talent	natural abilities or qualities
bequeath	leave or give, especially by will after one's death
mass production	the manufacturing of large quantities of goods
reel	a winder around which flexible materials can be wound
conciliate	gain the good will of or cause to be more favorably inclined
quay	wharf usually built parallel to the shoreline
slog	walk heavily and firmly, as when weary, or through mud
insinuate	suggest in an indirect or covert way; give to understand
gaunt	very thin especially from disease or hunger or cold
vile	morally reprehensible
pall	burial garment in which a corpse is wrapped
proffer	present for acceptance or rejection
bologna	a large smooth-textured smoked sausage
upswing	a physical movement from a lower to a higher level
persuasion	communication intended to induce belief or action
accession	the act of attaining a new office or right or position
aloof	distant, cold, or detached in manner
integral	existing as an essential constituent or characteristic
ensnarl	entangle or catch in (or as if in) a mesh
transgress	act in disregard of laws, rules, contracts, or promises
deacon	a cleric ranking just below a priest in Christian churches
besiege	surround so as to force to give up
bric-a-brac	small decorative objects
despotism	dominance through threat of punishment and violence
timpani	a large brass or copper drum
objurgate	censure severely
subsistence	a means of surviving
lacerated	irregularly slashed and jagged as if torn
muse	reflect deeply on a subject
destitute	poor enough to need help from others
racial profiling	the practice of targeting people due to their ethnicity
desolation	sadness resulting from being forsaken or abandoned
pestilent	likely to spread and cause an epidemic disease
campestral	of fields or open country
injure	cause bodily harm to
despond	lose confidence or hope; become dejected
rampart	an embankment built around a space for defensive purposes
callous	emotionally hardened
secrete	generate and separate from cells or bodily fluids
narcoleptic	of a disorder characterized by episodes of deep sleep
don	teacher at a university or college
congenial	suitable to your needs
morbid	suggesting the horror of death and decay
temporal	of or relating to or limited by time
galor	eexisting in abundance
mendacious	given to lying
coquettishly	in a flirtatious manner
indignation	a feeling of righteous anger
slew	a large number or amount or extent
tetchy	easily irritated or annoyed
languid	lacking spirit or liveliness
quiescent	being quiet or still or inactive
temperance	the trait of avoiding excesses
slovenly	negligent of neatness especially in dress and person
munificent	very generous
superfluous	more than is needed, desired, or required
profane	grossly irreverent toward what is held to be sacred
sheer	so thin as to transmit light
billow	a large sea wave
dissimulation	the act of deceiving
derision	the act of treating with contempt
iniquity	absence of moral or spiritual values
conspicuous	obvious to the eye or mind
decimation	the destruction or killing of a large part of the population
incapacitate	make unable to perform a certain action
indulgence	the act of gratifying a desire
ambivalent	uncertain or unable to decide about what course to follow
abate	become less in amount or intensity
transparent	able to be seen through with clarity
comeback	a quick reply to a question or remark
tamp	press down tightly
debate	a discussion with reasons for and against some proposal
intensify	increase in extent or strength
ornithologist	a zoologist who studies feathered animals
snorkel	device allowing a swimmer to breathe while face down
civil right	right belonging to a person by reason of citizenship
geothermal	of or relating to the heat in the interior of the earth
cargo	goods carried by a large vehicle
assassination	murder of a public figure by surprise attack
asthma	respiratory disorder characterized by wheezing
lunar	of or relating to or associated with the moon
commotion	a disorderly outburst or tumult
muster	summon up, call forth, or bring together
serenity	the absence of mental stress or anxiety
headway	forward movement
exasperation	actions that cause great irritation
copious	large in number or quantity
stamina	enduring strength and energy
translucent	allowing light to pass through diffusely
circumference	the length of the closed curve of a circle
adversary	someone who offers opposition
insert	introduce
lyric	of or relating to poetry that expresses emotion
version	something a little different from others of the same type
coronation	the ceremony of installing a new monarch
heroic	having qualities appropriate for brave figures
catalogue	a complete list of things, usually arranged systematically
valiant	having or showing heroism or courage
narrator	someone who tells a story
fragment	a piece broken off or cut off of something else
catatonic	characterized by unresponsiveness or lack of movement
turnstile	a rotating gate through which people can pass one by one
prima donna	a vain and temperamental person
prodigy	an unusually gifted or intelligent person
brusque	rudely abrupt or blunt in speech or manner
hurricane	a severe tropical cyclone usually with heavy rains and winds
diploma	a document certifying the completion of a course of study
lullaby	a quiet song intended to help a child go to sleep
collision	an accident resulting from violent impact of a moving object
feline	of or relating to cats
schwa	a neutral middle vowel that occurs in unstressed syllables
ravage	cause extensive destruction or ruin utterly
volcanic	relating to eruptions of gas and lava from the earth's crust
tabloid	sensationalist newspaper with half-size pages
bail	money forfeited if the accused fails to appear in court
bellicose	having or showing a ready disposition to fight
exalt	praise, glorify, or honor
captive	a person who is confined; especially a prisoner of war
transformer	an electrical device changing one voltage to another
straitlaced	exaggeratedly proper or morally strict
sprint	run very fast, usually for a short distance
dangle	hang freely
listeria	a bacteria that can contaminate food and make people sick
signature	your name written in your own handwriting
prehistory	the time during human culture before the written word
catalyst	substance that initiates or accelerates a chemical reaction
proprietary	protected by trademark or patent or copyright
collide	crash together with violent impact
ethic	the principles of right and wrong for an individual or group
indignantly	in a manner showing anger at something unjust or wrong
unconventional	not conforming to standards
coup	a sudden and decisive change of government by force
allergy	hypersensitive immunological reaction to some substance
theater	a building where performances can be presented
missile	a weapon that is forcibly thrown or projected at a target
cognition	the psychological result of perception and reasoning
senator	a member of a legislative assembly
marsh	low-lying wet land with grassy vegetation
mullet	freshwater or coastal food fish with a spindle-shaped body
meteor	a mass that enters earth's atmosphere, becoming incandescent
permafrost	ground that is permanently frozen
landmark	a prominent or well-known object in a particular place
apostrophe	a mark used to indicate the omission of one or more letters
surveillance	close observation of a person or group
nominee	a politician who is running for public office
seismic	subject to or caused by an earthquake or earth vibration
incinerate	become reduced to ashes
racketeering	engagement in an illegal enterprise carried on for profit
misconduct	activity that transgresses moral or civil law
vegetation	the process of growth in plants
unemployment	the state of not having a job
observatory	a building equipped to view astronomical phenomena
renewable	capable of being replaced
humanitarian	marked by devotion to popular welfare
sentry	a person employed to keep watch for some anticipated event
kindred	group of people related by blood or marriage
thwart	hinder or prevent, as an effort, plan, or desire
vie	compete for something
candid	openly straightforward and direct without secretiveness
imprudent	not sensible, responsible, or wise
ordained	fixed or established especially by command
mar	cause to become imperfect
forgo	do without or cease to hold or adhere to
feign	make believe with the intent to deceive
deification	elevation to the status of a god
pretext	a fictitious reason that conceals the real reason
tensile	of or relating to physical stress or strain
consecrated	made, declared, or believed to be holy
deliberation	careful consideration
pertinent	being of striking appropriateness
zeal	a feeling of strong eagerness
toil	work hard
torture	infliction of suffering to punish or obtain information
salve	a preparation applied externally as a soothing remedy
pious	having or showing or expressing reverence for a deity
adulation	exaggerated flattery or praise
bridle	headgear for a horse
recess	a state when work or action are paused
fathom	a linear unit of measurement for water depth
grime	thick or ingrained dirt
renown	the state or quality of being widely honored and acclaimed
sterile	incapable of reproducing
founder	a person who establishes some institution
ail	be unwell
contention	the act of competing as for profit or a prize
pettish	easily irritated or annoyed
grove	a small growth of trees without underbrush
carabiner	an oblong metal ring with a spring clip
lance	a long pointed rod used as a weapon
plume	the feather of a bird
interpose	introduce
grope	feel about uncertainly or blindly
prevailing	most frequent or common
inevitably	in such a manner as could not be otherwise
rosary	a series of prayers counted using a string of beads
flush	rinse, clean, or empty with a liquid
rapt	feeling great delight and interest
fore	situated at or toward the front
fixate	pay attention to exclusively and obsessively
shanty	a small crude shelter used as a dwelling
subjugation	forced submission to control by others
piety	righteousness by virtue of being religiously devout
strew	spread by scattering
trifling	not worth considering
endowed	provided or supplied or equipped with
tidings	information about recent and important events
denote	have as a meaning
contemptuous	expressing extreme scorn
lament	a cry of sorrow and grief
subsist	support oneself
discern	perceive, recognize, or detect
implore	beg or request earnestly and urgently
smitten	affected by something overwhelming
anecdote	short account of an incident
intoxicate	make drunk (with alcoholic drinks)
manifestation	a clear appearance
usage	the act of employing
recant	formally reject or disavow a formerly held belief
amiable	diffusing warmth and friendliness
righteousness	the quality of adhering to moral principles
steward	someone who manages property or affairs for someone else
vigor	forceful exertion
guise	an artful or simulated semblance
grimy	thickly covered with ingrained dirt
dedication	complete and wholehearted fidelity
dense	having high compaction or concentration
stolid	having or revealing little emotion or sensibility
cleave	separate or cut with a tool, such as a sharp instrument
hither	to this place
gong	a large metal disk that sounds a note when struck
solemn	dignified and somber in manner or character
dispense	administer or bestow, as in small portions
stimulus	any information or event that acts to arouse action
eminent	standing above others in quality or position
tread	put down, place, or press the foot
mishap	an unpredictable outcome that is unfortunate
cede	give over
home in	direct onto a target, especially by navigational aids
trifle	a detail that is considered insignificant
taboo	a ban resulting from social custom or emotional aversion
rage	a feeling of intense anger
baron	a nobleman (in various countries) of varying rank
unspoken	expressed without verbal communication
essay	an analytic or interpretive literary composition
cordiality	a politely warm and friendly disposition or attitude
intimate	marked by close acquaintance, association, or familiarity
procession	the act of moving forward, as toward a goal
prejudice	a partiality preventing objective consideration of an issue
puckish	naughtily or annoyingly playful
reproach	express criticism towards
stout	having rugged physical strength
augment	enlarge or increase
studied	produced or marked by conscious design or premeditation
needy	poor enough to need help from others
pervade	spread or diffuse through
revere	regard with feelings of respect
prudent	marked by sound judgment
utterly	completely and without qualification
pine	a coniferous tree
impenitent	not remorseful
potency	the power or right to give orders or make decisions
parish	a local church community
humble	marked by meekness or modesty; not arrogant or prideful