traer	to bring
levantarse	to get up
pensar	to think
cenar	to have dinner
pedir	to ask for
animar	to encourage
venir	to come
encontrar	to find
la estacion	season
empezar	to start
la pelicula	film
el invierno	winter
irse	to leave
estar	to be
el verano	summer
la cocina	kitchen
la semana	week
haber	to have	
ponerse	to put on
el otono	fall
ir	to go
la primavera	spring
mas	more
tambien	also
tranquilo	calm